11111111111111111111111111111111111111111111111111111111111111111111111111111111
00000000000000000000000000000000000000000000000000000000000000000000100000000000
00000000000000000000000000000000000000000000000000000000000000000000100000000000
00000000000000000000000000000000000000000000000000010000000000000000100000000000
00000000000000000000000000000000000000000000000000010000000000000000100000000000
0000x000000011111111000000000000011111111100000000011111111111111111111111111111
00000000000000000000000000000000000000000000000000000000000000000000000000000000
00000000000000000000000000000000000000000000000000000000000000000000000000000000
11111111111111111111111111110000000000000000000000000000000000000000000001111111
11111111111111111111111111111111111100000000000000000000000000000000000000000011
11111111111111111111111111111111111111111111100000000000000000000000011111111111
11111111111111111111111111111111111111111111111111111111111111111111111111111111