00000000000000333333330000000000000000000000000000000000000000000000000000000000
00000000000033333333333330000000000000000000000003333333333000000000000000000000
00000000000000003333330000000000000000000000000000000330000000000333333300000000
00000000000000000000000000000000000000000000000000000000000000000000000000000000
00000000000000000000000333333333333333000000000000000000000000000000000000000000
00000000000000000003333333333333333333000000000000000000000000000000000000000000
00000000000000000000000000000000000000000000000000000000000000000000000000000000
00000000000000000000000000000000000000000000000000000000000000000000000000000000
00000000000000000000000000000000000000000000000000000000000000000000000000000000
00000000000000000000000000000000000000000000000000000000000000000000000000000000
00000000000000000000000000000000000000000000000000000000000000000000000000000000
00000000000000000000000000000000000000000000000000000000000000000000000000000000